GGGGGGGGGGGGGGGGGGGGGGGGGGGGGGGG
GGGGGGGRRRRRRRRRRRRRRRGGGGGGGGGG
GGGGGGGRGGGGGGGGGGGGGRGGGGGGGGGG
GGGGHHHHHHGGGGGGGGGGGRGGGGGGGGGG
GGGGHHHHHHGGGGGGGGGGGRGGGGGGGGGG
GGGGHHHDHHGGGGGGGGGGGRGGGGGGGGGG
GGGGGGGGRRRRRRRRRRRRRRGGGGGGGGGG
GGGGGGGGRGGGGGPGGGGGGRGGGGGGGGGG
GGGGGGGGRGGGGGGGGGGGGRGGGGGGGGGG
GGGGGGGGRGGGGGGGGGGGGRGGGGGGGGGG
GGGGGGGGRRRRRRRRRRRRRRGGGGGGGGGG
GGGGGGGGGGGGGGGGGGGGGRGGGGGGGGGG
GGGGGGGGGGGGGGGGGGGGGRGGGGGGGGGG
GGGGGGGGGGGGGGGGGGGGGGGGGGGGGGGG
GGGGGGGGGGGGGGGGGGGGGGGGGGGGGGGG
